ABA=阿坝州
ACH=阿城
AKU=阿克苏
AAT=阿勒泰
ATU=阿图什
ANJ=安吉
AKA=安康
ANL=安陆
AQG=安庆
ANS=安顺
AYN=安阳
AOG=鞍山
MFM=澳门
BAZ=巴中
BAC=白城
BAS=白山
BSI=百色
BFU=蚌埠
BAV=包头
BAJ=宝鸡
BAD=保定
BSD=保山
BEA=北安
BDH=北戴河
BHY=北海
PEK=北京
BEL=北流
BEN=北宁
BEX=本溪
BIJ=毕节
BIZ=滨州
BOZ=亳州
BOL=博乐
CAZ=沧州
CDA=昌都
CDU=昌都地区
CHJ=昌吉
CGQ=长春
CGE=长葛
CSX=长沙
CIH=长治
CGD=常德
CHN=常宁
CHS=常熟
CZX=常州
CHU=巢湖
CHG=朝阳
CHY=潮阳
CZH=潮州
CEZ=郴州
CTU=成都
CHD=承德
CHA=澄海
CZU=池州
CHB=赤壁
CIF=赤峰
CHZ=崇州
CUZ=滁州
CHX=楚雄
CIX=慈溪
COH=从化
DZH=达州
DAA=大安
DAF=大丰
DLU=大理
DLC=大连
DAQ=大庆
DAT=大同
DAX=大兴安岭
DYE=大冶
DDG=丹东
DAJ=丹江口
DYA=丹阳
DAZ=儋州
DAY=当阳
DEL=德令哈
DEY=德阳
DZO=德州
DEF=登封
DEZ=邓州
DIG=迪庆
DIQ=迪庆州
DXN=定西
DIX=定西地区
DOT=东台
DGM=东莞
DOX=东兴
DYN=东阳
DOY=东营
DOJ=都江堰
DUJ=都匀
DUH=敦化
DNH=敦煌
EMS=峨眉山
ERD=鄂尔多斯
EZH=鄂州
ENP=恩平
ENH=恩施
ERL=二连浩特
PAY=番禺
FAC=防城港
FEC=丰城
FEH=奉化
FUO=佛山
FUA=福安
FUD=福鼎
FUQ=福清
FOC=福州
FUS=抚顺
FUZ=抚州
FUK=阜康
FUX=阜新
FUG=阜阳
FUY=富阳
GAZ=甘孜州
GZH=赣州
GAM=高明
GAY=高邮
GAC=藁城
GOQ=格尔木
GEJ=个旧
GOY=巩义
GUA=广安
GHN=广汉
GUS=广水
GUY=广元
CAN=广州
GUG=贵港
GUX=贵溪
KWE=贵阳
KWL=桂林
GUP=桂平
HRB=哈尔滨
HMI=哈密
HDO=海东
HAD=海东地区
HAK=海口
HAL=海林
HAM=海门
HAN=海南州
HAI=海宁
HDN=邯郸
HAC=韩城
HCH=汉川
HZG=汉中
HGH=杭州
HFE=合肥
HEZ=合作
HTN=和田
HEC=河池
HEY=河源
HZE=菏泽
HZH=贺州
HEB=鹤壁
HEG=鹤岗
HSH=鹤山
HEK=黑河
HSU=衡水
HNY=衡阳
HOH=洪湖
HOM=侯马
HET=呼和浩特
HUL=呼伦贝尔
HZO=湖州
HLD=葫芦岛
HLI=虎林
HDU=花都
HUD=华甸
HYI=华阴
HZU=化州
HUH=怀化
HUA=淮安
HUB=淮北
HUI=淮南
HUG=黄冈
HYE=黄骅
HUN=黄南州
TXN=黄山
HAI=海宁
HUS=黄石
HYN=黄岩
HUC=晖春
HYA=惠阳
HUZ=惠州
JXI=鸡西
KNC=吉安
JIL=吉林
JSH=吉首
JMO=即墨
JIA=集安
JIN=集宁
TNA=济南
JNG=济宁
JYA=济源
JMU=佳木斯
JIX=嘉兴
JGN=嘉峪关
JID=建德
JIO=建瓯
JYG=建阳
JDU=江都
JIM=江门
JSA=江山
JIY=江阴
JYO=江油
JAN=姜堰
JNA=胶南
JIZ=胶州
JZU=焦作
JHE=蛟河
JYN=揭阳
JIS=界首
JCH=金昌
JHA=金华
JIT=金坛
JNZ=锦州
JIC=晋城
JJA=晋江
JZO=晋中
JMN=荆门
JZG=荆州
JGS=井冈山
JDZ=景德镇
JIH=景洪
JIJ=靖江
JIU=九江
JZH=九寨沟
CHW=酒泉
JUR=句容
KHG=喀什
KAF=开封
KAP=开平
KYA=开原
KAY=开远
KAL=凯里
KLY=克拉玛依
KRL=库尔勒
KUT=奎屯
KMG=昆明
KUS=昆山
LXA=拉萨
LAN=六安
LAW=莱芜
LAY=莱阳
LZU=莱州
LAX=兰溪
LHW=兰州
LAF=廊坊
LAZ=阆中
LAH=老河口
LEC=乐昌
LEQ=乐清
LSA=乐山
LEZ=雷州
LES=冷水江
LSH=离石
LJG=丽江
LIJ=丽江地区
LIS=丽水
LYN=溧阳
LYG=连云港
LHO=连州
LYU=涟源
LIY=辽阳
LIU=辽源
LCN=聊城
LZI=林芝
LIZ=林芝地区
LZN=林州
LIA=临安
LCH=临沧
LIC=临沧地区
LIF=临汾
LHA=临海
LJN=临江
LIX=临夏
LYI=临沂
LIB=灵宝
LIH=凌海
LZH=柳州
LAN=六安
LIP=六盘水
LOJ=龙井
LOK=龙口
LOQ=龙泉
LOY=龙岩
LOD=娄底
LUZ=庐山
LZO=泸州
LUF=陆丰
LUX=潞西
LUD=罗定
LYA=洛阳
LUH=漯河
MAC=麻城
MAA=马鞍山
MAZ=满洲里
MAM=茂名
MES=眉山
MEH=梅河口
MZU=梅州
MEZ=孟州
MIQ=米泉
MIS=密山
MIG=绵阳
MIZ=绵竹
MDG=牡丹江
NEJ=内江
NAU=那曲
NAQ=那曲地区
NAA=南安
KHN=南昌
NAO=南充
NAH=南海
NKG=南京
NNG=南宁
NAP=南平
NTG=南通
NAX=南雄
NNY=南阳
NIA=宁安
NGB=宁波
NID=宁德
NIG=宁国
PZI=攀枝花
PAJ=盘锦
PEZ=彭州
PEL=蓬莱
PIZ=邳州
PDS=平顶山
PID=平度
PIH=平湖
PIL=平凉
PXA=凭祥
PIX=萍乡
PUT=莆田
PUY=濮阳
PUN=普宁
QIT=七台河
NDG=齐齐哈尔
QID=启东
QIH=千岛湖
QIJ=潜江
QZO=钦州
SHP=秦皇岛
QYA=沁阳
TAO=青岛
QIZ=青州
QYN=清远
IQN=庆阳
QIY=庆阳地区
QIL=邛崃
QHA=琼海
QUF=曲阜
QUJ=曲靖
JUZ=衢州
QUZ=泉州
REH=仁怀
REQ=任丘
RIK=日喀则
RIZ=日照
ROC=荣城
RUG=如皋
RUZ=汝州
RUS=乳山
RUA=瑞安
RUL=瑞丽
SAM=三门峡
SMI=三明
SAS=三水
SYX=三亚
SHG=山南
SHN=山南地区
SWA=汕头
SHW=汕尾
SHL=商洛
SHQ=商丘
SHA=上海
SHR=上饶
SYU=上虞
SZI=尚志
HSC=韶关
SHS=韶山
SWU=邵武
SYG=邵阳
SHX=绍兴
SZX=深圳
SNJ=神农架林区
SHE=沈阳
SZU=嵊州
SYA=十堰
SHH=石河子
SJW=石家庄
SHI=石狮
SSH=石首
SLA=舒兰
SHY=双鸭山
SHD=顺德
SHZ=朔州
SYM=思茅
SIH=四会
SIP=四平
SOY=松原
SOH=松滋
SOZ=松滋宾馆
SZV=苏州
XIQ=宿迁
XIO=宿州
SUF=绥芬河
SUH=绥化
SUZ=随州
SUN=遂宁
TCG=塔城
TSA=台山
TAZ=台州
TAC=太仓
TYN=太原
TAA=泰安
TAX=泰兴
TZU=泰州
TAS=唐山
TIC=天长
TSN=天津
TIM=天门
TIS=天水
TLI=铁力
TIL=铁岭
TNH=通化
TGO=通辽
TOS=通什
TOZ=通洲
TOL=同里
TOX=桐乡
TOC=铜川
TOG=铜陵
TOR=铜仁
TUL=吐鲁番
WAN=万宁
WEH=威海
WEF=潍坊
WEN=渭南
WEG=温岭
WEL=温蛉
WNZ=温州
WEC=文昌
WED=文登
WES=文山州
WHA=乌海
HLH=乌兰浩特
URC=乌鲁木齐
WUX=无锡
WJI=吴江
WHU=芜湖
WUZ=梧州
XZS=五指山
WUH=武汉
WUJ=武进
WUW=武威
WXI=武穴
WUS=武夷山
SIA=西安
XIC=西昌
XNN=西宁
JHG=西双版纳
XIL=锡林浩特
XMN=厦门
XIA=仙桃
XAN=咸宁
XIY=咸阳
HKG=香港
XIG=香格里拉
XIT=湘潭
XFN=襄樊
XCH=项城
XGN=孝感
XIU=忻州
XIH=新会
XIM=新密
XIX=新乡
XIN=新沂
XYU=新余
XYA=信阳
XYI=信宜
XEN=兴城
XYN=兴义
XNT=邢台
XUZ=徐州
XCA=许昌
XUC=宣城
YAA=雅安
YNT=烟台
ENY=延安
YNJ=延吉
YNZ=盐城
YZH=兖州
YAS=偃师
YAD=雁荡山
YAZ=扬中
YZO=扬州
YAC=阳春
YAJ=阳江
YAQ=阳泉
YAH=阳朔
YCH=伊春
YIN=伊宁
YIZ=仪征
YBP=宜宾
YIH=宜昌
YIC=宜春
YIX=宜兴
YZU=宜州
YIW=义乌
YIY=益阳
INC=银川
YIT=鹰潭
XYG=荥阳
YIK=营口
YOA=永安
YOK=永康
YOZ=永州
YUA=余姚
UYN=榆林
YUZ=禹州
YUL=玉林
YUM=玉门
YUS=玉树州
YUX=玉溪
YUY=岳阳
YNF=云浮
YUC=运城
ZAY=枣阳
ZAZ=枣庄
ZHL=扎兰屯
ZHA=湛江
ZHJ=张家港
DYG=张家界
ZJK=张家口
ZHY=张掖
ZHP=漳平
ZHZ=漳州
ZAT=昭通
ZHQ=肇庆
ZJA=镇江
CGO=郑州
ZIS=中山
ZHX=钟祥
CKG=重庆
HSN=舟山
ZHK=周口
ZHN=周庄
ZHO=株州
ZHC=株洲
ZUH=珠海
ZJI=诸暨
ZHM=驻马店
ZHU=涿州
ZIX=资兴
ZIY=资阳
ZIB=淄博
ZIG=自贡
ZOC=邹城
ZHH=遵化
ZYI=遵义
